###################################################################
#--------------------########-----------------#####################
#-#########-#################-###############-#####################
#-#########-#####-######-####-###############--------------------##
#-#########-#####-######-####-###############-#####################
#-#########-#####-######-----------------------------------------##
#-----------------######-####-###############-############-########
#####-#####-############-####-########-------------#######-########
#####-##################----#-############################-########
#####-##################-####-----------------------------------###
#####--------------------############################-#########-###
########################-############################-#############
####---------------------###-----------------------------###-----##
####-###################-###################################-###-##
####-###################-###################################-###---
####-####----------------###------------------##-------------###-## 
########################-###-###################-#########---###-##
###########--------#####-###---------------------#########-########
####-######-############-###-#################-###########-########
####-######-############-###-#################-###########-########
####---------------------------------------###-------------------## 
###########-###################### ################ ###############
###########-######------------------------------------------#######
###################################################################
